10 10
.........T
XX...XX...
X.........
XXXXXXX...
....XG....
XX..X.X...
....XXXS..
XX...XX.K.
..........
XX...XX...
9 255