12 17
......XXXX.......
.XXXX.XXXXX.XXXX.
.XXXX.XXXXX.XXXX.
.XXXX.XXXXX.XXXX.
.........GG......
.XXXX.XX.XX.XX.XX
.XXXX.XX.XX.XX.XX
.....SXX..XPXX...
.XXXX.XXXXX.XXXXX
.XXXX.XXXXX.XXXXX
.XXXX.XXXXX.XXXXX
T..........K.....
