16 23
G.....P......X.......K.
.XXXXX.XXXXX.X.XXXXXXX.
.XXXXX.XXXXX.X.XXXXXXX.
.XXXXX.XXXXX.X.XXXXXXX.
.XXXXX.XXXXX.X.........
.XXXXX.XXXXX.X.XXXXXXX.
.XXXXX.XXXXX.X.XXXXXXX.
S......................
.XXXXXX.XXXXXXX.XXXXXXX
.XXXXXX.XXXXXXX.XXXXXXX
.XXXXXX.XXXXXXX.XXXXXXX
..............T.......X
.XXXXXX.XXXXXXX.XXXXXXX
.XXXXXX.XXXXXXX.XXXXXXX
.XXXXXX.XXXXXXX.XXXXXXX
....................G.X