12 18
......XXXX........
.XXXX.XXXXX.XXXX.X
.XXXX.XXXXX.XXXX.X
.XXXX.XXXXX.XXXX.X
.........GG.......
.XXXX.XX.XX.XX.XXX
.XXXX.XX.XX.XX.XXX
.....SXX..XPXX....
.XXXX.XXXXX.XXXXX.
.XXXX.XXXXX.XXXXX.
.XXXX.XXXXX.XXXXX.
T..........K......